bloco_inquebravel: .word 16, 16
.byte 12,21,22,21,21,21,21,21,21,21,21,21,21,21,12,11,
22,30,30,30,30,30,30,30,30,22,22,22,22,22,13,12,
22,30,30,22,22,22,22,22,22,22,22,22,22,21,13,12,
22,30,22,22,22,22,22,22,22,22,22,22,22,21,13,12,
22,30,22,22,22,22,22,22,22,22,22,22,22,21,13,12,
22,30,22,22,22,22,22,22,22,22,22,22,22,21,13,12,
22,22,22,22,22,22,22,22,22,22,22,22,22,21,13,12,
22,22,22,22,22,22,22,22,22,22,22,22,22,21,13,12,
22,22,22,22,22,22,22,22,22,22,22,22,22,21,13,12,
22,22,22,22,22,22,22,22,22,22,22,22,22,21,13,12,
22,22,22,22,22,22,22,22,22,22,22,22,22,21,13,12,
22,22,22,22,22,22,22,22,22,22,22,22,22,21,13,12,
22,22,22,22,22,22,22,22,22,22,22,22,22,21,13,12,
22,22,22,22,22,22,22,22,22,22,22,22,21,21,13,12,
13,21,21,21,21,21,21,21,13,21,21,21,13,13,13,12,
12,13,12,13,12,12,12,12,12,12,12,12,12,12,12,11,