bloco_quebravel: .word 16, 16
.byte 0,11,21,21,21,21,21,21,21,21,21,21,20,12,10,0,
10,22,30,30,22,22,22,22,22,22,22,22,22,22,12,2,
12,30,31,30,30,22,22,22,22,22,22,22,22,22,13,12,
20,30,30,22,22,22,22,22,22,22,22,22,22,21,13,12,
20,22,22,22,22,22,22,22,22,22,22,22,22,21,13,12,
20,22,22,22,22,22,22,22,22,22,22,22,22,21,13,11,
20,22,22,22,22,22,22,22,22,22,22,22,22,21,13,11,
12,22,22,22,22,22,22,22,22,22,22,22,22,21,13,11,
12,22,22,22,22,22,22,22,22,22,22,22,22,21,13,11,
12,22,22,22,22,22,22,22,22,22,22,22,22,21,13,11,
12,22,22,22,22,22,22,22,22,22,22,22,22,21,13,11,
12,22,22,22,22,22,22,22,22,22,22,22,22,13,13,11,
12,22,22,22,22,22,22,22,22,22,22,22,22,13,13,11,
12,22,22,21,21,21,21,21,21,21,21,21,21,13,13,11,
2,12,13,13,13,13,13,13,13,13,13,13,13,13,12,1,
0,2,12,12,12,12,12,12,12,12,12,12,12,12,2,0,
